
  WE                            assets/grey_stone.xpm 
NO      assets/purple_stone.xpm



SO assets/wall_brick.xpm

F     110, 133 , 114

EA assets/wood.xpm



C 240,     175, 232

111111111111111111111111
100110000100010000000001
1000001000000000000N0001
11111111111  111111111111
