   WE                            subject.pdf 
NO      subject.pdf



SO subject.pdf

F      28  ,    100,    10

EA subject.pdf



C 225,   30,4


         11111111111111111111111
        100000000011000000001
        110001100000000000011111111111
   1111110000N00000000000000011
1111001000000010100000000000011
100000000110000011101111111111111111111
11110111111111011100000010001
11110111111111011101010010001111
1100000011010101110000001000  1
10000000000000011000000100010111
10000000000000001101010010001
11000001110101011111011110 011
11110111 1110101 10111101000111
11111111 1111111 111111111111
11111111 1111111 111111111111
11111111111111111111111111111