   WE                            subject.pdf 
NO      subject.pdf



SO subject.pdf

F      28  ,    100,    10

EA subject.pdf



C 225,   30,4


         11111111111111111111111
        10000000011000N00001
        110001100001110000011111111111
   1111110000000000000000011
11110011000001110000000000001
100000000110000011101111111111111111111
11110111111111011100000010001
11110111111111011101010010001111
1100000011010101110000001000001
100000000000110000001001011111
1000000000000110101001000011
11000001110101011111011110 011
11110111 1110101 10111101000111
11111111 1111111 111111111111
11111111 1111111 111111111111
11111111111111111111111111111