   WE                            ./path_to_the_west_texture 
NO      ./path_to_the_north_texture



SO ./path_to_the_south_texture

F      2800  ,    100,    45

EA ./path_to_the_east_texture



C 225,   30,4


         11111111111111111111111
        100000000011000000001
        11000110000011100000000011111111111
   1011110000000000000000000011
111100111000001110000000000001
1000000000110000011101111111111111111111
11110111111111011100000010001
11110111111111011101010010001
11000000110101011100000010001
1000000000000001100000010001
10000000000000001101010010001
11000001110101011111011110N011
11110111 1110101 101111010001
11111111 1111111 111111111111
11111111 1111111 111111111111
11111111111111111111111111111